######################################
#       	3                    #
# *                         1        #
#                                    #
#   #######  #######   ###########   #
#   #######  #  1      #   4     #   #
#   #######  #         # $ #     #   #
#   #######  #    ###########    #   #
#     1                     #  2 #  1#
#                           #    #   # 
#   #######   #########     #    #   #
#   #    2    #                  #   #
#   #         #  3          2    #   #
#   #######   #        ###########   #
#             #  2                   #
#   2         #                2     #
######################################