######################################
#¤                      9999         #
# *            888         9      $  #
#                       9999         #
######################################
